border_size=1
usage=map

_off^_usr   , _off^_usr   , _off^_usr   , _off^_usr   , _off^_usr   , _off^_usr   , _off^_usr   , _off^_usr   , _off^_usr   , _off^_usr   , _off^_usr   , _off^_usr   , _off^_usr   , _off^_usr   , _off^_usr   , _off^_usr   , _off^_usr   , _off^_usr   , _off^_usr   , _off^_usr   , _off^_usr   , _off^_usr   , _off^_usr   , _off^_usr   , _off^_usr   , _off^_usr   , Xu          , Xu          , Xu          , Xu          , Xu          , Xu          , Xu          , Xu          , Xu          , Xu          , Xu          , Xu          , Xu          , Xu          , Xu          , Xu          
_off^_usr   , _off^_usr   , _off^_usr   , _off^_usr   , _off^_usr   , _off^_usr   , _off^_usr   , _off^_usr   , _off^_usr   , _off^_usr   , _off^_usr   , _off^_usr   , _off^_usr   , _off^_usr   , _off^_usr   , _off^_usr   , _off^_usr   , _off^_usr   , _off^_usr   , _off^_usr   , _off^_usr   , _off^_usr   , _off^_usr   , _off^_usr   , Xu          , Xu          , Xu          , Xu          , Xu          , Xu          , Xu          , Xu          , Xu          , Xu          , Xu          , Xu          , Xu          , Xu          , Xu          , Xu          , Xu          , Xu          
_off^_usr   , _off^_usr   , _off^_usr   , _off^_usr   , _off^_usr   , _off^_usr   , _off^_usr   , _off^_usr   , _off^_usr   , _off^_usr   , _off^_usr   , _off^_usr   , _off^_usr   , _off^_usr   , _off^_usr   , _off^_usr   , _off^_usr   , _off^_usr   , _off^_usr   , _off^_usr   , _off^_usr   , _off^_usr   , Xu          , Xu          , Xu          , Xu          , Xu          , Xu          , Gg          , Xu          , Gg          , Xu          , Gg          , Xu          , Gg          , Xu          , Gg          , Xu          , Gg          , Xu          , Gg          , Xu          
_off^_usr   , _off^_usr   , _off^_usr   , _off^_usr   , _off^_usr   , _off^_usr   , _off^_usr   , _off^_usr   , _off^_usr   , _off^_usr   , _off^_usr   , _off^_usr   , _off^_usr   , _off^_usr   , _off^_usr   , _off^_usr   , _off^_usr   , _off^_usr   , _off^_usr   , _off^_usr   , Xu          , Xu          , Xu          , Xu          , Xu          , Xu          , Xu          , Gg          , Gg          , Gg          , Gg          , Gg          , Gg          , Gg          , Gg          , Gg          , Gg          , Gg          , Gg          , Gg          , Gg          , Gg          
_off^_usr   , _off^_usr   , _off^_usr   , _off^_usr   , _off^_usr   , _off^_usr   , _off^_usr   , _off^_usr   , _off^_usr   , _off^_usr   , _off^_usr   , _off^_usr   , _off^_usr   , _off^_usr   , _off^_usr   , _off^_usr   , _off^_usr   , _off^_usr   , Xu          , Xu          , Xu          , Xu          , Xu          , Xu          , Mm          , Xu          , Gs^Fds      , Gg          , Gg          , Gg          , Gg          , Gg          , Gg          , Gg          , Gg          , Gg^Vh       , Gg          , Gg          , Gg          , Gg          , Gg          , Gg          
_off^_usr   , _off^_usr   , _off^_usr   , _off^_usr   , _off^_usr   , _off^_usr   , _off^_usr   , _off^_usr   , _off^_usr   , _off^_usr   , _off^_usr   , _off^_usr   , _off^_usr   , _off^_usr   , _off^_usr   , _off^_usr   , Xu          , Xu          , Xu          , Xu          , Xu          , Xu          , Mm          , Mm          , Mm          , Hh^Fp       , Hh^Fp       , Gs^Fds      , Gs^Fds      , Gg          , Ch          , Ch          , Ch          , Gg          , Gg          , Gg          , Gg          , Gg          , Ch          , Ch          , Gg          , Gg          
_off^_usr   , _off^_usr   , _off^_usr   , _off^_usr   , _off^_usr   , _off^_usr   , _off^_usr   , _off^_usr   , _off^_usr   , _off^_usr   , _off^_usr   , _off^_usr   , _off^_usr   , Xu          , Xu          , Xu          , Xu          , Xu          , Xu          , Xu          , Mm          , Mm          , Hh          , Mm          , Hh          , Hh^Fp       , Gg          , Gg          , Gs^Fds      , Gg          , Ch          , 1 Kh        , Ch          , Gg          , Gg          , Gg          , Gg          , Gg          , Ch          , Kh          , Gg          , Gg          
_off^_usr   , _off^_usr   , _off^_usr   , _off^_usr   , _off^_usr   , _off^_usr   , _off^_usr   , _off^_usr   , _off^_usr   , _off^_usr   , _off^_usr   , _off^_usr   , Xu          , Xu          , Xu          , Xu          , Xu          , Xu          , Hh^Fp       , Hh^Fms      , Hh^Fms      , Hh          , Hh          , Hh          , Gg          , Gg          , Gs^Fds      , Gg          , Gg          , Gg          , Ch          , Ch          , Ch          , Gg          , Gg          , Gg^Fet      , Gg          , Gg          , Gs^Fds      , Ch          , Gg          , Gg          
_off^_usr   , _off^_usr   , _off^_usr   , _off^_usr   , _off^_usr   , _off^_usr   , _off^_usr   , _off^_usr   , _off^_usr   , _off^_usr   , Xu          , Xu          , Xu          , Xu          , Xu          , Xu          , Gg          , Gg          , Gg          , Gg          , Gg          , Hh          , Gg          , Gs^Fds      , Gg          , Gs^Fds      , Gs^Fds      , Gg          , Gg          , Gg          , Ch          , 2 Kh        , Ch          , Gg          , Gg          , Gg          , Gg          , Gg          , Gs^Fds      , Gs^Fds      , Gg          , Gg          
_off^_usr   , _off^_usr   , _off^_usr   , _off^_usr   , Xu          , _off^_usr   , _off^_usr   , _off^_usr   , Xu          , Xu          , Xu          , Xu          , Xu          , Xu          , Gg          , Gg          , Gg          , Gg          , Gg          , Gg          , Gg          , Gg          , Gs^Fds      , Gg          , Gs^Fds      , Gs^Fds      , Gg          , Gg          , Gg          , Gg          , Ch          , Ch          , Ch          , Gg          , Gg          , Gg          , Gg          , Gg          , Gs^Fds      , Gs^Fds      , Gg          , Gg          
_off^_usr   , _off^_usr   , Xu          , Xu          , Xu          , Xu          , Xu          , Xu          , Xu          , Xu          , Xu          , Xu          , Ur^Ii       , Ur^Ii       , Ur^Ii       , Gg          , Gg          , Gg          , Gg          , Gg          , Gg          , Gg          , Gs^Fds      , Gs^Fds      , Gs^Fds      , Gg          , Gg          , Gg          , Gg          , Gg          , Ch          , 3 Kh        , Ch          , Gg          , Gg          , Gg^Vh       , Gs^Fds      , Gs^Fds      , Gs^Fds      , Gs^Fds      , Xu          , Xu          
Xu          , Xu          , Xu          , Xu          , Xu          , Xu          , Xu          , Xu          , Xu          , Xu          , Ur          , Ur          , Qlf         , Uu^Ii       , Uu^Ii       , Ur^Ii       , Chr         , Gg          , Gg          , Gg          , Gg          , Gg          , Gs^Fds      , Gs^Fds      , Gs^Fds      , Gs^Fds      , Gg          , Gg          , Gg          , Gg          , Gg          , Ch          , Gg          , Gg          , Gg          , Gg          , Gg          , Gs^Fds      , Xu          , Xu          , Xu          , Xu          
Xu          , Xu          , Ql          , Xu          , Ql          , Ql          , Xu          , Xu          , Ur          , Ur          , Qlf         , Uu          , Qlf         , Uu          , Uu          , Ur^Ii       , 7 Khr       , Chr         , Chr         , Gg          , Gg          , Gg          , Xu          , Gs^Fds      , Xu          , Gs^Fds      , Gs^Fds      , Gg          , Gs^Fds      , Gs^Fds      , Gs^Fds      , Gs^Fds      , Gs^Fds      , Gs^Fds      , Gs^Fds      , Gg          , Xu          , Xu          , Xu          , Xu          , Xu          , Xu          
Xu          , Xu          , Ql          , Ql          , Ql          , Ql          , Ql^Bs/      , Ur          , Uu          , Qlf         , Xu          , Xu          , Uu          , Qlf         , Uu^Ii       , Uu^Ii       , Chr         , Chr         , Xu          , Xu          , Xu          , Xu          , Xu          , Xu          , Xu          , Xu          , Xu          , Xu          , Xu          , Xu          , Xu          , Gs^Fds      , Xu          , Xu          , Xu          , Xu          , Xu          , Xu          , Xu          , Xu          , Xu          , Xu          
Xu          , Ql          , Ql          , Ql          , 9 Kud       , Cud         , Ql          , Ql          , Xu          , Xu          , Qxu         , Qxu         , Qxu         , Uu^Ii       , Uu^Ufi      , Uu          , Uu^Uf       , Xu          , Xu          , Xu          , Xu          , Xu          , Xu          , Xu          , Xu          , Xu          , Xu          , Xu          , Xu          , Xu          , Xu          , Xu          , Xu          , Xu          , Xu          , Xu          , Xu          , Xu          , Xu          , Xu          , Xu          , Xu          
Xu          , Ql          , Ql          , Ql          , Ql          , Cud         , Ql^Bs\      , Ql          , Uu          , Xu          , Qxu         , Qxu         , Qlf         , Uu          , Uu          , Uu          , Chr         , Xu          , Xu          , Xu          , Xu          , Xu          , Xu          , Xu          , Xu          , Xu          , Xu          , Xu          , Xu          , Xu          , Xu          , Xu          , Xu          , Xu          , Xu          , Xu          , Xu          , Xu          , Xu          , Xu          , Xu          , Xu          
Xu          , Xu          , Ql          , Ql          , Ql          , Ql          , Ql          , Ur          , Ur          , Uu          , Qlf         , Qlf         , Uu          , Uu          , Uh          , Uu^Ii       , 8 Khr       , Chr         , Chr         , Xu          , Gg          , Xu          , Hh^Fp       , Xu          , Gs^Fds      , Xu          , Gg          , Xu          , Gg          , Xu          , Gg          , Xu          , Gs^Fds      , Xu          , Gg          , Xu          , Gs^Fds      , Xu          , Xu          , Xu          , Xu          , Xu          
Xu          , Xu          , Xu          , Xu          , Xu          , Ql          , Xu          , Xu          , Xu          , Ur          , Ur          , Uu^Uf       , Uu          , Uu^Uf       , Uh^Ii       , Ur^Ii       , Chr         , Chr         , Ggf         , Ggf         , Gg          , Gg          , Gg          , Gs^Fds      , Gs^Fds      , Gs^Fds      , Gg          , Gg          , Gg          , Gs^Fds      , Gg          , Gg          , Gg          , Gs^Fds      , Gs^Fds      , Gs^Fds      , Ggf         , Gs^Fds      , Gs^Fds      , Xu          , Xu          , Xu          
_off^_usr   , Xu          , Xu          , Xu          , Xu          , Xu          , Xu          , Xu          , Xu          , Xu          , Xu          , Ur          , Ur^Ii       , Uu^Ii       , Ur^Ii       , Ur^Ii       , Rr          , Rr          , Ggf         , Ggf         , Ggf         , Ggf         , Gs          , Gg          , Gs^Fds      , Gs^Fds      , Gg          , Gg          , Gg          , Gs^Fds      , Ch          , Ch          , Ch          , Ggf         , Ggf         , Gg^Vh       , Ggf         , Gg          , Gs^Fds      , Gg          , Gg          , Xu          
_off^_usr   , _off^_usr   , _off^_usr   , Xu          , Xu          , Xu          , _off^_usr   , Xu          , Xu          , Xu          , Xu          , Xu          , Xu          , Ur^Ii       , Gg          , Gg          , Gg          , Ggf         , Ggf         , Ggf         , Gs^Fds      , Gs^Fds      , Gs          , Gs          , Gs^Fds      , Gs^Fds      , Gg          , Gg          , Gg          , Gs^Fds      , Ch          , 4 Kh        , Ch          , Ggf         , Gg          , Gg          , Gg          , Gg          , Gs^Fds      , Gs^Fds      , Gg          , Gg          
_off^_usr   , _off^_usr   , _off^_usr   , _off^_usr   , _off^_usr   , _off^_usr   , _off^_usr   , _off^_usr   , _off^_usr   , Xu          , Xu          , Xu          , Xu          , Xu          , Xu          , Gg          , Gg          , Gg          , Ggf         , Gg          , Gs^Fds      , Gs^Fds      , Gs          , Gs          , Gs          , Gs^Fds      , Gg          , Gg          , Gg          , Gg          , Ch          , Ch          , Ch          , Ggf         , Gg          , Gg          , Gg          , Gg          , Gs^Fds      , Gs^Fds      , Gg          , Gg          
_off^_usr   , _off^_usr   , _off^_usr   , _off^_usr   , _off^_usr   , _off^_usr   , _off^_usr   , _off^_usr   , _off^_usr   , _off^_usr   , _off^_usr   , Xu          , Xu          , Xu          , Xu          , Xu          , Xu          , Ggf         , Hh^Fp       , Gs^Fds      , Hh^Fds      , Gg          , Gg          , Gs          , Gs^Fds      , Gs^Fds      , Gg          , Gg          , Gg          , Gg          , Ch          , 5 Kh        , Ch          , Gg          , Gs^Fds      , Gg^Fet      , Ggf         , Gg          , Ch          , Ch          , Gg          , Gg          
_off^_usr   , _off^_usr   , _off^_usr   , _off^_usr   , _off^_usr   , _off^_usr   , _off^_usr   , _off^_usr   , _off^_usr   , _off^_usr   , _off^_usr   , _off^_usr   , _off^_usr   , Xu          , Xu          , Xu          , Xu          , Xu          , Xu          , Hh^Fp       , Hh^Fp       , Hh^Fms      , Hh^Fms      , Gg          , Gg          , Gg          , Gg          , Gg          , Gs^Fds      , Gg          , Ch          , Ch          , Ch          , Gg          , Gs^Fds      , Gg          , Gg          , Gg          , Ch          , Kh          , Gg          , Gg          
_off^_usr   , _off^_usr   , _off^_usr   , _off^_usr   , _off^_usr   , _off^_usr   , _off^_usr   , _off^_usr   , _off^_usr   , _off^_usr   , _off^_usr   , _off^_usr   , _off^_usr   , _off^_usr   , _off^_usr   , Xu          , Xu          , Xu          , Xu          , Xu          , Xu          , Hh^Fms      , Hh^Fms      , Hh^Fms      , Hh^Fms      , Gg          , Gs^Fds      , Gg          , Gs^Fds      , Gg          , Ch          , 6 Kh        , Ch          , Gg          , Gs^Fds      , Gg          , Gg          , Gg          , Gg          , Ch          , Gs^Fds      , Gg          
_off^_usr   , _off^_usr   , _off^_usr   , _off^_usr   , _off^_usr   , _off^_usr   , _off^_usr   , _off^_usr   , _off^_usr   , _off^_usr   , _off^_usr   , _off^_usr   , _off^_usr   , _off^_usr   , _off^_usr   , _off^_usr   , _off^_usr   , Xu          , Xu          , Xu          , Xu          , Xu          , Xu          , Xu          , Xu          , Gs^Fds      , Gg          , Gs^Fds      , Gg          , Gs^Fds      , Gg          , Ch          , Gg          , Gg          , Gs^Fds      , Gg^Vh       , Gg          , Gg          , Gg          , Gs^Fds      , Gg          , Gg          
_off^_usr   , _off^_usr   , _off^_usr   , _off^_usr   , _off^_usr   , _off^_usr   , _off^_usr   , _off^_usr   , _off^_usr   , _off^_usr   , _off^_usr   , _off^_usr   , _off^_usr   , _off^_usr   , _off^_usr   , _off^_usr   , _off^_usr   , _off^_usr   , _off^_usr   , Xu          , Xu          , Xu          , Xu          , Xu          , Xu          , Xu          , Xu          , Xu          , Xu          , Gg          , Gg          , Gg          , Xu          , Gg          , Gg          , Gs^Fds      , Gg          , Gg          , Gs^Fds      , Gs^Fds      , Gg          , Gg          
_off^_usr   , _off^_usr   , _off^_usr   , _off^_usr   , _off^_usr   , _off^_usr   , _off^_usr   , _off^_usr   , _off^_usr   , _off^_usr   , _off^_usr   , _off^_usr   , _off^_usr   , _off^_usr   , _off^_usr   , _off^_usr   , _off^_usr   , _off^_usr   , _off^_usr   , _off^_usr   , _off^_usr   , Xu          , Xu          , Xu          , Xu          , Xu          , Xu          , Xu          , Xu          , Xu          , Xu          , Xu          , Xu          , Xu          , Xu          , Xu          , Xu          , Xu          , Xu          , Xu          , Xu          , Xu          
_off^_usr   , _off^_usr   , _off^_usr   , _off^_usr   , _off^_usr   , _off^_usr   , _off^_usr   , _off^_usr   , _off^_usr   , _off^_usr   , _off^_usr   , _off^_usr   , _off^_usr   , _off^_usr   , _off^_usr   , _off^_usr   , _off^_usr   , _off^_usr   , _off^_usr   , _off^_usr   , _off^_usr   , _off^_usr   , _off^_usr   , Xu          , Xu          , Xu          , Xu          , Xu          , Xu          , Xu          , Xu          , Xu          , Xu          , Xu          , Xu          , Xu          , Xu          , Xu          , Xu          , Xu          , Xu          , Xu          
